11111111111111111111111
100000000000000E0000111
11110000000000111111111
100P0000000000100001111
10000000000100100000111
10001111000111100000001
10000001000000000000001
10000001111111100000001
1C000000000100100000001
10000000000000100000001
11111111111111111111111