11111111111111111111111
1P00000000000000000C111
11110000000C00111111111
10000000000000100001111
100C0010000100100000111
10001111000111100000001
10000001000000000000001
1000000111111110000C001
10000000000100100000001
10000000000C001000000E1
11111111111111111111111